	   ?        
	   !
       !  #    #
 #  @  =###    #
 ###=##=###    #
 #  = #####    #
 #  = #####    #
 #  = ---------#
 #^ #######    #
 ###############