          #
 #  @  =### 
 ###=##=### 
 #  = ##### 
 #  = ##### 
 #  = ----# 
 #  ####### 
 ##########