          #    #
 #  @  =###    #
 ###=##=###    #
 #  = #####    #
 #  = #####    #
 #  = ---------#
 #^ #######    #
 ###############