       ?        
       !        
       !  #    #
 #  @^ =0##    #
 ###=##=###    #
 #  = #####    #
 #  = #####    #
 #  =^---------#
 #  #######    #
 ###############
 000000000000000