       ?       
       !       
       !  #   #
 #  @^ =0##   #
 ###=##=###   #
 #  = #####   #
 #  = #####   #
 # ==^--------#
 # =#######  ^#
 ##=###########
 # =         ##
 00000000000000